SO ./path_to_the_south_texture
NO ./path_to_the_north_texture
EA ./path_to_the_east_texture
WE ./path_to_the_west_texture
F 204,204,255
C 254,254,226

11111111111111111111111
10000000000000000000001
10000000000000000000001
10000000000000000000001
10000000000000000000001
10000000000000000000001
10000000011110000000001
10000000000000000000001
10000000000000000000001
10000000000000000000001
10100000000000000010001
1001000000E000000001001
10100000000000000010001
10000000000000000000001
10000000000000000000001
10000000001000000000001
11111111111111111111111