NO ./textures/redbrick.xpm
SO ./textures/purplestone.xpm
EA ./textures/greystone.xpm
WE ./textures/bluestone.xpm
F 204,204,234
C 255,255,234

11111111111111111111111
10000000000000000000001
111110000000000000000001
    10000100000000000011111
11111010000000000000001
10000000000000000001001
10000000000001001000001
100000000000000000000011111
100001000000000000000000001
100001000000000000000000W01
101000000001000000100000001
100100000000010000010011111
10100000000000000010001
10000010000000000000001
10010000000000000000111
10000000001000000000001
10000000001000000000001
10000000001000000000001
10000000001000000000001
10000000001000000000001
10000000000000000000001
10000000001000000000001
10000000001000000000001
10000000000000000000001
10000000001000000000001
10000000001000000000001
10000000000000000000001
10000000001000000000001
10000000001000000000001
10000000001000000000001
10000000000000000000001
10000000001000000000001
10000000001000000000001
10000000001000000000001
11111111111111111111111
