SO ./path_to_the_south_texture
NO ./path_to_the_north_texture
EA ./path_to_the_east_texture
WE ./path_to_the_west_texture
F 204,204,255
C 254,254,226

11111111111111111111111
10000111011100100011111
10000000011100100011111
10001110010000110011111
11001010010000011111111
11001110010111000110011
10000000000110001110011
10100000000E00011111111
10000000000001100111111
11111110000000000000001
11111110000000000000001
11111110000000000000001
11111110011100000000001
10100000000000011111111
10100110000000011111111
10000000000001100111111
10000000000001100111111
10000000000001100111111
10000000000001100111111
10000000000001100111111
11111110000000000101111
10000000000001100111111
10000000000001100111111
11111111111111111111111