SO ./textures/purplestone.xpm
NO ./textures/redbrick.xpm
EA ./textures/greystone.xpm
WE ./textures/bluestone.xpm
F 204,204,255
C 254,254,226

11111111111111111111111
10000000000000000000001
10000000000000000000001
10000000000000000000001
10000000000000000000001
10000000000001000000001
10000000011110100000001
10000000000000000000001
10000000000000000000001
10000000000000000000001
10100000000000000010001
10010000000000000001001
10100000000000000010001
10000000000000000000001
10000000000000000000111
100000000010000000000E1
11111111111111111111111